111111111111111111111111111111
101010000000000111111111111111
110P00000000000000000000000001
101010000000000111111111111101
100100000000000000000000000101
100000000000000000000000000101
10000000C000000000000000000101
100000000000000000000000000101
100000000000000000000E00000011
111111111111111111111111111111
